SO       pics/purplebricks.xpm
NO       pics/redbricks.xpm
EA       pics/graybricks.xpm
WE        pics/yellowbricks.xpm

F 82,70,50
C 138,209,227


1111111111111111111111111111111111111111111111111
1000000000000000000000000000000000000000000000001
1011D100000000000000000000000000000000000001D1101
101001000000000000000000W000000000000000000100101
101D11000000000000000000000000000000000000011D101
1000000000000000000000000000000000000000000000001
1000000000000000000000001000000000000000000000001
1000000000000000000000000000000000000000000000001
1000000000000000000000000000000000000000000000001
1000000000000000000000000000000000000000000000001
1000000000000000000000000000000000000000000000001
1000000000000000000000000000000000000000000000001
1000000000000000000000000000000000000000000000001
1000000010000000000000000F00000000000000001000001
1000000000000000000000000000000000000000000000001
1000000000000000000000000000000000000000000000001
1000000000000000000000000000000000000000000000001
1000000000000000000000000000000000000000000000001
1000000000000000000000000000000000000000000000001
1000000000000000000000000000000000000000000000001
1000000000000000000000001000000000000000000000001
1000000000000000000000000000000000000000000000001
101D11000000000000000000000000000000000000011D101
1010010000000000000000000000000000000000000100101
1011D100000000000000000000000000000000000001D1101
1000000000000000000000000000000000000000000000001
1111111111111111111111111111111111111111111111111