SO       pics/purplebricks.xpm
NO       pics/redbricks.xpm
EA       pics/graybricks.xpm
WE        pics/yellowbricks.xpm

F 82,70,50
C 138,209,227


1111111111111111111111111111111111111111111111111
1000000000000000000000000000000000000000000000001
1011010000000000000000000000000000000000000101101
101001000000000000000000N000000000000000000100101
1010110000000000000000000000000000000000000110101
1000000000000000000000000000000000000000000000001
1000000000000000000000001000000000000000000000001
1000000000000000000000000000000000000000000000001
1000000000000000000000000000000000000000000000001
1000000000000000000000000000000000000000000000001
1000000000000000000000000000000000000000000000001
1000000000000000000000000000000000000000000000001
1000000000000000000000000000000000000000000000001
1000000010000000000000000000000000000000001000001
1000000000000000000000000000000000000000000000001
1000000000000000000000000000000000000000000000001
1000000000000000000000000000000000000000000000001
1000000000000000000000000000000000000000000000001
1000000000000000000000000000000000000000000000001
1000000000000000000000000000000000000000000000001
1000000000000000000000000100000000000000000000001
1000000000000000000000000000000000000000000000001
1010110000000000000000000000000000000000000110101
1010010000000000000000000000000000000000000100101
1011010000000000000000000000000000000000000101101
1000000000000000000000000000000000000000000000001
1111111111111111111111111111111111111111111111111