111111111111111111111111
1E1000000000000C00000C01
10000101000C000000000001
101000C00000000000000001
1P0000000C00C00000000F01
111111111111111111111111