111111111111111111111111
1E1000000000000C00000C01
10000101000C0000E0000001
101000C00000000000000001
1P000F000C00C00000000001
111111111111111111111111